#0#####
#0000##
####0##
#0000##
#0#####
#00000#
#####0#