#0########
#000#00000
###0#0####
#000#00000
#0#######0
#000000000
#########0
#0#0000000
#0#0######
#000000000