#0#####
#00000#
###0##0
#000000
#0##00#
#000#0#
#####0#