#0##########
#0000#00000#
####0#0###0#
#0000#0#0#0#
#0####0#0#00
#00000000##0
####0#####00
#0##0#00000#
#0000##0##00
#0#########0
#0000#000000
##########0#